#I#############
#             #
#             #
#             #
#             #
#             #
#             #
#             #
############O##
