#I#############
#       #     #
# ### # # ### #
#   # #   ### #
### ########  #
#   #   ####  #
# ### ###### ##
# #    ##### ##
#   ##     ####
############O##
