#I#############
#       #     #
# ### # # ### #
#   # #   ### #
### ########  #
#   #         #
# ### ###### ##
# #    ########
#   ##       ##
############O##
